书=はん
包,公文包=かばん
笔记本,本子=ノート
铅笔=えんぴつ
伞=かさ
鞋=くつ
报纸=しんぶん
杂志=ざっし
词典=じしょ
照相机=カメラ
电视机=テレビ
个人电脑=パソコン
收音机=ラジオ
电话=でんわ
桌子,书桌=つくえ
椅子=いす
钥匙,锁=かぎ
钟,表=とけい
记事本=てちょう
照片=しゃしん
车=くるま
自行车=じてんしゃ
礼物=おみやげ
特产,名产=めいさんひん
丝绸=シルク
手绢=ハンカチ
公司=がいしゃ
(敬称)位,人=かた
人=ひと
家人,家属=かぞく
(我)母亲=はは
母亲=おかあさん
日语=にほんご
汉语,中文=ちゅうごくご
这,这个=これ
那,那个=あれ
哪个=どれ
什么=なん
谁=だれ
哪位=どなた
这,这个=この
那,那个=あの
哪个=どの
日本=にほん
长岛=ながしま
多大=おいくつ
