百货商店=デパート
食堂=しょくどう
邮局=ゆうびんきょく
银行=ぎんこう
图书馆=としょかん
(高级)公寓=マンシヨン
宾馆=ホテル
便利店=コンビニ
咖啡馆=きっさてん
医院=びょういん
书店=ほんや
餐馆=ルストラン
大楼=ビル
建筑物=たてもの
柜台=うにば
厕所=トイレ
入口=いりぐち
出口=でくち
事务所=じむしょ
接待处=うけつけ
降价处理大卖场=バーグンかいじょう
自动扶梯=エスカレーター
衣服=ふく
风衣,大衣=コート
数码相机=デジカメ
国家=くに
地图=ちず
旁边=となり
附近,周边=しゅうへん
今天=きょう
星期三=すいようび
星期四=もくようび
这里,这儿=ここ
那里,那儿=そこ
那儿,那边=あそこ
这儿,这边=こちら
哪里,哪儿=どこ
哪边=どちら
请问,对不起=あのう
上海=シャンハイ
东京=とうきょう
多少钱=いくら
