茶=おちゃ
寿司=すし
饭=ごはん
水=みず
律师/弁護士=べんごし
学生=がくせい
医生=いしゃ
老师=せんせい
温柔的/優しい=やさしい
酷的/凉爽的=かっこいい
人=ひと
你好=こんにちは
晚上好=こんばんは
花/鼻子=はな
又/再=また
蓝/青=あお
红/赤=あか
白=しろ
一=いち
二=に
三=さん
四=よん
五=ご
六=ろく
七=なな
八=はち
九=きゅう
十=じゅう
早=おはよう
再见=さようなら
晚上/夜=よる
你好=こんにちは
蔬菜/野菜=やさい
酒=おさけ
读/読=よむ
脏的/汚い=きたない
喝/飲む=のむ
穿=きる
照烧=てりやき
夏天=なつ
阴天/曇=くもり
晴天=はれ
冬天=ふゆ
白天/昼=ひる
鸟=とり
狗/犬=いぬ
猫=ねこ
家=いえ
房间/部屋=へや
外面=そと
背部/背中=せなか
眼睛/目=め
耳朵=みみ
我/私=わたし
表情符号=えもじ
漫画=まんが
票=きっぷ
地图=ちず
包=かばん
电话=でんわ
铅笔=えんぴつ
学校=がっこう
今天=きょう
天妇罗/天麩羅=てんぷら
纳豆=なっとう
便当=べんとう
水果=くだもの
喜欢=すき
蛋糕=ケーキ
沙拉=サラダ
披萨=ピザ
拉面=ラーメン
这个=これ
好吃的/美味的=おいしい
巴西=ブラジル
美国=アメリカ
加拿大=カナダ
越南=ベトナム
小的=ちいさい
大的=おおきい
酒店=ホテル
大学=だいがく
百货商店=デパート
便利店=コンビニ
公交站/バス停=ばすてい
车站/駅=えき
哪里=どこ
这里=ここ
不=いいえ
不是=じゃない
包=カバン
外套=コート
鞋子/靴=くつ
手套/手袋=てぶくろ
白色的=しろい
红色的=あかい
请=とうぞ
银行=ぎんこう
谢谢=ありがとう
对不起/请问=すみません
